14 9
XXXXXXXXX
X0X0000SX
X0X0XXX0X
X0X0X0X0X
X0000000X
X0XXX0X0X
S0X0X0X0X
XXXXX0XXX
X0X000X0X
X0X0X0X0X
X000X000X
X0XXX0X0X
X0X0X0X0X
XXXXXXXXX
